[OVERLAY]
┌──────────────────┐
│    ゜             │
│メッセーシ  おそい ふつう はやい│
│                  │
│アニメーション    ふつう はやい│
│    ゜             │
│せんとうしかん    ふつう はやい│
│            ゜     │
│           としる    │
└──────────────────┘