[OVERLAY]
└──────────────────┘
┌──────────────────┐
│  ゜゜              │
│セーフかしゅうリょうしました    │
│                  │
│                  │
└──────────────────┘