[OVERLAY]
┌──────┐
│      │
│ あたま  │
│  ゜ ゜ │
│ みきうて │
│  ゜  ゜│
│ ひたリうて│
│    ゜ │
│ きゃくふ │
└──────┘