[OVERLAY]
┌──────────────┐
│ ゜  ゜         │
│ テータかこわれています  │
│ ゜            │
│ テータをクリアします   │
│             ▽│
└──────────────┘