[OVERLAY]
┌──────────────────┐
│ ゜  ゜ ゜ ゛ ゜       │
│みき・ひたリて ヘーシきリかえ   │
│                  │
│                  │
└──────────────────┘