[OVERLAY]
┌─────────┐
│ ステータスをみる│
│         │
│ せんとうかいし │
│  ゜      │
│ もとる     │
└─────────┘