[OVERLAY]
×========+
/ ゜      ~
/なくる     ~
/゜       ~
/かむしゃら   ~
/        ~
/うつ      ~
/        ~
/ねらいうち   ~
/        ~
/おうえん    ~
/        ~
/まもる     ~
/        ~
/なおす     ~
/        ~
/そのほか    ~
Ｆ::::::::-
