[OVERLAY]
×========+
/        ~
/        ~
/        ~
/        ~
/        ~
/        ~
/        ~
/ ランク    ~
/  ゜     ~
/ レヘル    ~
♥\x4e\x4e\x4e\x4e\x4e\x4e\x4e\x4e\x4f
/        ~
/        ~
/        ~
/        ~
Ｆ::::::::-
