[OVERLAY]
×========+
/ランク     ~
/ ゜      ~
/レヘル     ~
/        ~
/けいけんち   ~
/        ~
/ あと     ~
♥\x4e\x4e\x4e\x4e\x4e\x4e\x4e\x4e\x4f
/  ゜     ~
/こうけき    ~
/゜ ゜     ~
/ほうきょ    ~
/        ~
/とくしゅ    ~
/        ~
/あいしょう   ~
Ｆ::::::::-
