[OVERLAY]
┌─────────┐
│       ゜ │
│ チームからはすす│
│         │
│ ステータスをみる│
│         │
│ せんとうかいし │
│  ゜      │
│ もとる     │
└─────────┘