[OVERLAY]
┌──────────────────┐
│    ゜  ゜          │
│セレクトホタンて いれかえます   │
│                  │
│                  │
└──────────────────┘