[OVERLAY]
×========+
/        ~
/        ~
/        ~
/        ~
/        ~
/        ~
/        ~
/        ~
/        ~
/        ~
Ｆ::::::::-
