[OVERLAY]
┌──────────────────┐
│                  │
│いくつ?      コ    00Ｆ│
│     ゜            │
│もってるかす    コ       │
└──────────────────┘